Ala	丙氨酸	Alanine	A
Arg	精氨酸	Arginine	R
Asn	天冬酰胺	Asparagine	N
Asp	天冬氨酸	Aspartic acid	D
Asx	Asn + Asp	B
Cys	半胱氨酸	Cysteine	C
Gln	谷氨酰胺	Glutamine	Q
Glu	谷氨酸	Glutamic acid	E
Glx	Gln + Glu	Z
Gly	甘氨酸	Glycine	G
His	组氨酸	Histidine	H
Ile	异亮氨酸	Isoleucine	I
Leu	亮氨酸	Leucine	L
Lys	赖氨酸	Lysine	K
Met	甲硫氨酸	Methionine	M
Phe	苯丙氨酸	Phenylalanine	F
Pro	脯氨酸	Proline	P
Ser	丝氨酸	Serine	S
Thr	苏氨酸	Threonine	T
Trp	色氨酸	Tryptophan	W
Tyr	酪氨酸	Tyrosine	Y
Val	缬氨酸	Valine	V
